type octile
height 8
width 8
map
..T.TTT.
........
.....T..
........
...T....
...T.T..
........
.TTT..T.
