type octile
height 8
width 8
map
.T.T....
........
...TT...
........
.....T.T
.TTT....
.....T..
.T...T..
