type octile
height 8
width 8
map
.......T
.TTT....
.T......
........
.TTT....
........
T.T.TT..
........
