type octile
height 8
width 8
map
T.......
TT.TT..T
TT.TT...
..T.....
........
T.......
........
........
