type octile
height 8
width 8
map
TTT...T.
........
.TT.....
.TT..T..
.......T
......T.
........
..T.....
