type octile
height 8
width 8
map
.TT...T.
........
.TTT.TT.
....T...
........
.....TT.
...T....
........
