type octile
height 8
width 8
map
.......T
........
..TTT.TT
T....TT.
........
........
..T..T..
..T.....
