type octile
height 8
width 8
map
...TTT.T
......TT
T....T..
........
........
..T.....
.TT....T
........
