type octile
height 8
width 8
map
TTT.T...
........
.....TT.
...T....
.......T
.....TT.
.......T
.......T
