type octile
height 8
width 8
map
.TTTT...
..T.....
T.......
......T.
.T...T..
.....T..
.......T
...T....
