type octile
height 8
width 8
map
........
........
...TTT..
...TT...
....T...
.....TT.
.T...T..
.....TT.
