type octile
height 8
width 8
map
......TT
....T...
.....T..
.TTTT..T
T.....T.
........
....T...
........
