type octile
height 8
width 8
map
T.......
........
....TTTT
......TT
....T..T
T.......
....T...
.T......
