type octile
height 8
width 8
map
TT......
....TTT.
.T....TT
........
..T..T..
......T.
T.......
........
