type octile
height 8
width 8
map
.....TTT
....T...
...T.T.T
....T...
T.T.....
.....T..
........
....T...
