type octile
height 8
width 8
map
........
T.......
TT.....T
...TTTT.
T.......
...T....
.......T
.......T
