type octile
height 8
width 8
map
.TT...T.
........
.TT.....
.T......
.T.T.T..
...TT...
.......T
........
