type octile
height 8
width 8
map
.TTT....
.T......
T.....TT
..TT....
T.......
.TT.....
........
........
