type octile
height 8
width 8
map
........
T.......
T.......
........
..TTT...
....TT..
TT.T....
...TT...
