type octile
height 8
width 8
map
T...TTT.
........
.....TT.
....T...
....T...
T....T..
......T.
.T......
