type octile
height 8
width 8
map
........
.TT.TTT.
...T.T..
..T...T.
........
........
...T..T.
.......T
