type octile
height 8
width 8
map
........
....T.T.
.....TT.
.....TT.
.T......
...TT..T
.....T..
...T....
