type octile
height 8
width 8
map
.....T..
..TT....
......T.
.....TT.
........
...TTT..
..T.....
.T.T....
