type octile
height 8
width 8
map
........
..T.....
TT.TTT..
........
...TT...
.T..T...
.....T..
.......T
