type octile
height 15
width 41
map
.........................................
...@@@@@@@@@@@.@@@@@@@@@@@.@@@@@@@@@@@...
.........................................
.........................................
...@@@@@@@@@@@.@@@@@@@@@@@.@@@@@@@@@@@...
.........................................
.........................................
...@@@@@@@@@@@.@@@@@@@@@@@.@@@@@@@@@@@...
.........................................
.........................................
...@@@@@@@@@@@.@@@@@@@@@@@.@@@@@@@@@@@...
.........................................
.........................................
...@@@@@@@@@@@.@@@@@@@@@@@.@@@@@@@@@@@...
.........................................
